00100100000010011001111000100011001000000000000001
11001010100000000110010010100010001100100000001010
00100001010001100110100000000111011010100101100000
00110100000000011000000000010001000000000000010001
10001000001000001010011010100001011011000100001110
00000000100101111000110001000001000100011000000000
01111000011011000001000000111000011000000101011000
11101000101000001111010011000000100010000010000100
00010100100000000001111100000100000000100101011011
00110000000101101100001001000000010000111000010001
00010110100110000000010010111100000010100110000001
10100101000010000001001100010001000010100001000100
00110100000110100100000010101010000000000001010111
01010000101110010010111010100001001000110000000000
10000010001101101010011011000101100011010010010000
00000101001010110000000111001001001000110111001000
00101001011100100000010001100000001000111010010010
00000000011000010000010000101100000100110000100000
00010011000100001100101000001000110110001000010010
01111000010110001000000000000000111011110000011100
10010010101000000100000100000101001111000010000111
00010000000101100000110001010100000000110000000010
11011000001010100100010000000001010000111000000000
00001000100010011010010101101000111010000001000110
00000000000000000100001101101011010000100000001110
00000000101000000000100100101000111001010000000100
00001000001100100110100100101001000000100010100000
11000010010101000010010001001000100000000011010111
00001001101001011000000100001011110101111010001100
10000110101110010000001100000000100000100000001000
00100010001010100010110000010000000010110000011110
00000110010001010101000000000101000110100011101000
10100000010011100100000110111000001111000000001000
01001011101000000000011100001001101001000100001000
00001010101000010001110000100010000111011000011000
00000000010001010001010111000000000010000010001000
00000010010100011001000100000000100000000100000010
01100010010100100001100000000000011000001010001000
00000000000010001100000100001000100000010000000000
00001000000000010100001101000001001100010110011110
00010000000110100010100101010010001000010100001000
10110000010010100000101000000000001011010000000001
11001000000100000000001000000100010001001000010110
10001000000101000000100000000001100010010010111100
01110000000000100110100101000011001101000010000000
10010100010000001111100101001000101000010000000001
10000100001000010010000001000100100000000011010101
11100010000111111010000000101001000100010100001011
00001000101110000000000001011010001010010101000110
11000010010000011000011110001101000000000110101100